Festival de Alegre divulga classificadas
<b>  </b><br>
 <br>
Das 1.180 músicas de todo o Brasil inscritas para o 22º Festival de Música de Alegre, 22 foram pré-classificadas para o concurso – entre elas, três canções são de capixabas. A seleção foi feita pelo músico Luzinho Marques, do Departamento de Repertório Nacional da BMG Music Publishing Brasil. 
Os concorrentes se preparam, agora, para mostrar todo o seu talento durante o festival, que será realizado de 25 a 28 próximos, no Parque de Exposições e Centro de Lazer Geraldo Santos.
Os candidatos concorrem a R$ 55 mil em prêmios e está sendo esperado um público de 100 espectadores.

As músicas

• Deuses da Garganta – Luiz Carlos de Castro Pereira (RJ)
• O Que Manda no Mundo é o Dinheiro – Adelson da Silva Machado (RJ)
• Hippiezinha – Paul Dougllas Braga da Silva (RJ)
• Osso Duro de Roer – Josué Pinheiro Roque (RJ)
• Homem não Chora – Jonny e Gusta (RJ)
• Canoa Brasil – Paulinho de Castro (RJ)
• Universidade do Samba – Bruno Castro (RJ)
• Mendigo da Hóstia – Álvaro Socci e Cláudio da Matta (RJ)
• O Pranto de Irineu – Wilsinho Saravá, Júlio Menezes e Noemea Castro (RJ)
• Terra Mãe-Terra Pai – Zé Alexandre (RJ)
• Confissões – Cláudio Fraga (MG)
• Pra Estourar – Wilson Sideral (MG)
• Moda de Viola Pelo Ar – Teleu e Sanvida (SP)
• Esse Fogo Chamado Desejo – Ito Moreno (SP)
• Milagreiro – José Eduardo Santana e Rita Altério (SP)
• Donos do Mundo – Edu Marengoni e Silvinho Ferreira (SP)
• Vilas Lobo a Canção – Carlos Gomes (SP)
• Nave Protonotária – Ademir Pedrosa e Cléverson Baia (AP)
• Santa Cecília – Fabrício dos Anjos (PA)
• Novo Mundo – Nando Levy (ES)
• Lições Sobre o Tempo – Douglas Gonçalves Lopes (ES)
• Armagedom – Luis Alberto Valadão de Azeredo (ES) <br><br><hr>
Data da Publicação: 17/05/2005 - Pagina: 07 <br>
Editoria: At2 <br><br>