Inscrição para Saúde até sexta
<b> Há vagas para
fonoaudiólogos,
enfermeiros e 
médicos do Iesp.
Salários chegam
a R$ 2,6 mil </b><br>
 <br>
Fim de prazo para o processo seletivo simplificado do Instituto Estadual de Saúde Pública (Iesp), ligado à Secretaria de Estado da Saúde, destinado à formação de quadro de reserva. As inscrições para a seleção, com oportunidades temporárias para fonoaudiólogo, enfermeiro e médico, terminam na sexta-feira (dia 17).
Para os cargos de fonoaudiólogo e enfermeiro, a remuneração oferecida é de R$ 1,3 mil (jornada de 40 horas semanais).
O vencimento do médico, por sua vez, varia conforme a carga horária: R$ 1,3 mil (20 horas), R$ 1.560,00 (24 horas) e R$ 2,6 mil (40 horas).
O processo de seleção será feito por avaliação de títulos. Os documentos e a ficha de inscrição (disponível no endereço www.saude.es.gov.br) devem ser enviados para o instituto pelos Correios. O Iesp fica na avenida Marechal Mascarenhas de Moraes, 2.025, em Bento Ferreira, Vitória.
Nenhum novo documento poderá ser apresentado após o ato da inscrição. Conforme as regras da seleção, só será permitida uma inscrição por candidato, devendo o mesmo fazer opção por apenas um cargo e por apenas uma das unidades ofertadas, que deverão constar na ficha de inscrição.
Os aprovados vão compor o cadastro de reserva e serão convocados para o trabalho de acordo com as necessidades da administração.
A jornada de trabalho está sujeita a sistema de plantões noturnos ou diurnos, sendo obrigatório o comparecimento de acordo com a escala de trabalho estabelecida pela unidade de saúde, para todos os cargos, sendo eliminado imediatamente o candidato que não se adequar a mesma.
O edital contendo todas as regras da seleção pode ser consultado no site da Secretaria da Saúde (www.saude.es.gov.br).

Cargo e local de lotação

• Fonoaudiólogo: Crefes
• Enfermeiro: HEMOESL, HMSA, HRAS
• Médico:
Cardiologia: CA, HABF, HDRC, SRSC
Cirurgia Cabeça e Pescoço: HINSG
Cirurgia Geral: CA, HABF, HDDS, SRSC
Cirurgia Plástica: HABF, HDDS
Cirurgia Pediátrica: HABF
Clínica Médica: CA, HDDS, HDRC, HMSA, HRAS, HPF, SRSC
Dermatologia: HDRS
Endocrinologia: HDDS
Gastroenterologia: Hiaba
Geriatria: CA, HPF
Ginecologia/Obstetrícia: HABF, HDDS, HDRS, HMSA, HRAS, HSJC
Hematologia e Hemoterapia adulto: HABF, HDDS
Infectologia: HABF, HDDS, HIABA, HSL
Medicina do Trabalho: SRSCI
Nefrologia: HDDS
Neurologia: SRSCI
Neuropediatria: Hiaba
Nutrólogo: HSL
Oftalmologia: HMSA
Ortopedia e Traumatologia: HDRC, HSJC, SRSCI
Otorrinolaringologia: Hiaba
Patologia: HDDS
Pediatria: CA, HDDS, Hiaba, HINSG, HMSA, HRAS, HSJC, SRSC, SRSCI
Pneumologia: SRSV
Reumatologia: SRSV
Socorrista: HABF, HDDS, HDRC, HMSA
Ultra-sonografia: HDDS, HSL
Urologia: SRSCI
• Legendas 
CA – Central Administrativa
HABF – Hospital Antônio Bezerra de Farias (Vila Velha)
HDDS – Hospital Dr. Dório Silva (Serra)
HDRC – Hospital Drª. Rita de Cássia (Barra de São Francisco)
Hiaba – Hospital Infantil Alzir Bernardino Alves (Vila Velha)
HINSG – Hospital Infantil Nossa Senhora da Glória (Vitória)
HMSA – Hospital e Maternidade Silvio Ávidos (Colatina)
HPF – Hospital Pedro Fontes (Cariacica)
HRAS – Hospital Roberto Arnizault Silvares (São Mateus)
HSJ – Hospital São José (São José do Calçado)
Crefes – Centro de Reabilitação Física do Espírito Santo (Vila
Velha)
HEMOESL – Hemocentro Linhares
SRSC – Superintendência Regional de Saúde de Colatina
SRSCI – Superintendência Regional de Saúde de Cachoeiro de
Itapemirim
SRSV – Superintendência Regional de Saúde de Vitória
HSL – Hospital São Lucas (Vitória) <br><br><hr>
Data da Publicação: 13/11/2006 - Pagina: 17 <br>
Editoria: Concursos <br><br>