Ficha de inscrição para o Iesp
<b> Interessados poderão se
inscrever até o dia 17 no
novo concurso aberto
pela Secretaria da Saúde </b><br>
 <br>
O Instituto Estadual de Saúde Pública (Iesp), ligado à Secretaria de Estado da Saúde, abre hoje inscrições para um processo seletivo destinado à formação de quadro de reserva. As oportunidades temporárias são para fonoaudiólogo, enfermeiro e médico.
Os interessados poderão se inscrever até o próximo dia 17 por meio do requerimento de inscrição que está sendo publicado por A Tribuna.
A seleção será feita por avaliação de títulos e os documentos devem ser enviados para o Iesp junto com esta ficha pelos Correios. O instituto fica na avenida Marechal Mascarenhas de Moraes, 2.025, em Bento Ferreira, em Vitória. Nenhum novo documento poderá ser apresentado após o ato da inscrição.
Segundo as regras do processo seletivo, só será permitida uma inscrição por candidato, devendo o mesmo fazer opção por apenas um cargo e por apenas uma das unidades ofertadas, que deverão constar na ficha de inscrição.
Para os cargos de fonoaudiólogo e enfermeiro, a remuneração oferecida é de R$ 1,3 mil (jornada de 40 horas semanais). O vencimento do médico, por sua vez, varia conforme a carga horária: R$ 1,3 mil (20 horas), R$ 1.560,00 (24 horas) e R$ 2,6 mil (40 horas).
Os aprovados vão compor o cadastro de reserva e serão convocados para o trabalho de acordo com as necessidades da administração.
O edital contendo todas as regras da seleção deverá ser disponibilizado hoje no site da Secretaria da Saúde (www.saude.es.gov.br).

Oportunidades

Cargo e local de lotação
n Fonoaudiólogo: Crefes
n Enfermeiro: HEMOESL, HMSA, HRAS
n Médico:
• Cardiologia: CA, HABF, HDRC, SRSC
• Cirurgia Cabeça e Pescoço: HINSG
• Cirurgia Geral: CA, HABF, HDDS, SRSC
• Cirurgia Plástica: HABF, HDDS
• Cirurgia Pediátrica: HABF
• Clínica Médica: CA, HDDS, HDRC, HMSA, HRAS, HPF, SRSC 
• Dermatologia: HDRS
• Endocrinologia: HDDS
• Gastroenterologia: Hiaba
• Geriatria: CA, HPF
• Ginecologia/Obstetrícia: HABF, HDDS, HDRS, HMSA, HRAS, HSJC
• Hematologia e Hemoterapia adulto: HABF, HDDS
• Infectologia: HABF, HDDS, HIABA, HSL
• Medicina do Trabalho: SRSCI
• Nefrologia: HDDS
• Neurologia: SRSCI
• Neuropediatria: Hiaba
• Nutrólogo: HSL
• Oftalmologia: HMSA
• Ortopedia e Traumatologia: HDRC, HSJC, SRSCI
• Otorrinolaringologia: Hiaba
• Patologia: HDDS
• Pediatria: CA, HDDS, Hiaba, HINSG, HMSA, HRAS, HSJC, SRSC, SRSCI
• Pneumologia: SRSV
• Reumatologia: SRSV
• Socorrista: HABF, HDDS, HDRC, HMSA
• Ultra-sonografia: HDDS, HSL
• Urologia: SRSCI
• CA – Central Administrativa

Legendas
• HABF – Hospital Antônio Bezerra de Farias (Vila Velha)
• HDDS – Hospital Dr. Dório Silva (Serra)
• HDRC – Hospital Drª. Rita de Cássia (Barra de São Francisco)
• Hiaba – Hospital Infantil Alzir Bernardino Alves (Vila Velha)
• HINSG – Hospital Infantil Nossa Senhora da Glória (Vitória)
• HMSA – Hospital e Maternidade Silvio Ávidos (Colatina)
• HPF – Hospital Pedro Fontes (Cariacica)
• HRAS – Hospital Roberto Arnizault Silvares (São Mateus)
• HSJ – Hospital São José (São José do Calçado)
• Crefes – Centro de Reabilitação Física do Espírito Santo (Vila Velha)
• HEMOESL – Hemocentro Linhares
• SRSC – Superintendência Regional de Saúde de Colatina
• SRSCI – Superintendência Regional de Saúde de Cachoeiro de Itapemirim
• SRSV – Superintendência Regional de Saúde de Vitória
• HSL – Hospital São Lucas (Vitória) <br><br><hr>
Data da Publicação: 26/10/2006 - Pagina: 24 <br>
Editoria: Concursos <br><br>